0	0	3	2	3	0	0
0	3	2	2	2	3	0
3	2	2	2	2	2	3
1	1	1	1	1	1	1
1	1	1	1	1	1	1
1	1	1	1	1	1	1
3	2	2	2	2	2	3
0	3	2	2	2	3	0
0	0	3	2	3	0	0