0	0	0	3	0	0	0
0	0	3	2	3	0	0
0	3	2	1	2	3	0
3	2	1	1	1	2	3
2	1	1	1	1	1	2
3	2	1	1	1	2	3
0	3	2	1	2	3	0
0	0	3	2	3	0	0
0	0	0	3	0	0	0