1	1	1	1	1	1	1
1	1	1	1	1	1	1
1	1	2	0	2	1	1
1	2	0	0	0	2	1
2	0	0	3	0	0	2
0	0	3	34	3	0	0
3	3	34	3	34	3	3
1	1	1	1	1	1	1
1	1	1	1	1	1	1