1	1	1	1	1	1	1
1	1	1	1	1	1	1
1	2	2	2	2	2	1
1	3	0	0	0	2	1
1	3	3	3	0	2	1
1	3	0	0	0	2	1
1	24	24	24	24	24	1
1	1	1	1	1	1	1
1	1	1	1	1	1	1