1	1	0	0	0	1	1
1	1	1	1	1	1	1
35	35	35	35	35	35	35
0	3	3	0	3	3	0
0	3	3	0	3	3	0
0	3	3	0	3	3	0
34	34	34	34	34	34	34
1	1	1	1	1	1	1
1	1	0	0	0	1	1