1	1	1	1	1	1	1
1	1	1	1	1	1	1
1	0	0	35	0	0	1
1	0	35	3	35	0	1
1	34	3	3	3	34	1
1	0	34	3	34	0	1
1	0	0	34	0	0	1
1	1	1	1	1	1	1
1	1	1	1	1	1	1