3	1	1	1	1	1	3
0	2	1	2	1	2	0
3	1	3	1	3	1	3
0	2	1	2	1	2	0
3	1	3	1	3	1	3
0	2	1	2	1	2	0
34	1	34	1	34	1	34
0	24	1	24	1	24	0
3	1	1	1	1	1	3