1	1	1	1	1	1	1
1	1	1	1	1	1	1
1	0	0	0	0	0	1
1	0	35	35	35	0	1
1	3	3	3	3	3	1
1	0	35	35	35	0	1
1	0	0	0	0	0	1
1	1	1	1	1	1	1
1	1	1	1	1	1	1