3	0	3	0	3	0	3
1	2	1	2	1	2	1
1	1	1	1	1	1	1
1	1	1	1	1	1	1
1	1	1	1	1	1	1
1	1	1	1	1	1	1
1	1	1	1	1	1	1
14	1	14	1	14	1	14
0	3	0	3	0	3	0