3	0	3	0	3	0	3
1	2	1	2	1	2	1
1	1	1	1	1	1	1
1	1	1	1	1	1	1
1	1	1	1	1	1	1
1	1	1	1	1	1	1
1	1	1	1	1	1	1
15	1	15	1	15	1	15
0	3	0	3	0	3	0