1	1	1	1	1	1	1
1	1	1	1	1	1	1
1	35	0	35	0	35	1
1	3	35	3	35	3	1
1	0	3	0	3	0	1
1	1	1	1	1	1	1
1	34	2	34	2	34	1
1	2	34	2	34	2	1
1	1	1	1	1	1	1