1	1	1	1	1	1	1
1	1	3	3	3	1	1
1	1	3	0	3	1	1
1	3	0	0	0	3	1
1	3	0	0	0	3	1
14	3	0	0	0	3	14
1	34	0	0	0	34	1
1	1	34	0	34	1	1
1	1	3	3	3	1	1