1	1	3	0	3	1	1
1	1	3	0	3	1	1
1	1	0	0	3	1	1
1	1	3	0	3	1	1
1	1	3	0	0	1	1
1	1	3	0	3	1	1
14	14	0	0	3	14	14
1	1	3	0	3	1	1
1	1	3	0	3	1	1