1	35	3	3	3	35	1
1	0	35	35	35	0	1
1	35	3	3	3	35	1
1	0	34	34	34	0	1
1	35	3	3	3	35	1
1	0	35	35	35	0	1
1	35	3	3	3	35	1
1	0	34	34	34	0	1
1	35	3	3	3	35	1