1	1	1	1	1	1	1
1	1	1	1	1	1	1
25	25	25	25	25	25	25
2	0	3	0	3	0	2
2	3	3	3	3	3	2
2	0	3	0	3	0	2
25	25	25	25	25	25	25
1	1	1	1	1	1	1
1	1	1	1	1	1	1