1	1	1	34	0	1	1
1	1	1	34	0	1	1
1	2	35	0	0	0	1
1	2	35	35	0	2	1
1	2	0	35	35	2	1
1	2	0	35	35	2	1
1	0	0	0	35	2	1
1	1	0	34	1	1	1
1	1	1	34	1	1	1