1	1	1	1	1	1	1
1	1	1	1	0	35	1
1	1	1	0	35	2	1
1	1	0	35	2	34	1
1	0	35	2	34	0	1
1	35	2	34	0	1	1
1	2	34	0	1	1	1
1	34	0	1	1	1	1
1	1	1	1	1	1	1