1	0	1	1	1	1	1
1	35	0	1	1	1	1
1	2	35	0	1	1	1
1	34	2	35	0	1	1
1	0	34	2	35	0	1
1	1	0	34	2	35	1
1	1	1	0	34	2	1
1	1	1	1	0	34	1
1	1	1	1	1	0	1