1	1	1	1	1	1	1
1	2	0	0	0	2	1
1	2	0	35	0	2	1
1	2	34	35	34	2	1
1	2	0	35	0	2	1
1	2	34	35	34	2	1
1	2	0	35	0	2	1
1	2	0	0	0	2	1
1	1	1	1	1	1	1