1	1	1	1	1	1	1
1	0	35	0	35	0	1
1	0	35	34	35	0	1
1	0	35	0	35	0	1
1	0	35	34	35	0	1
1	0	35	0	35	0	1
1	1	1	1	1	1	1
1	1	1	1	1	1	1
1	1	1	1	1	1	1