1	1	1	1	1	1	1
1	1	1	0	1	1	1
1	1	1	0	1	1	1
1	0	0	34	0	0	1
1	35	35	34	35	35	1
1	0	0	34	0	0	1
1	1	1	0	1	1	1
1	1	1	0	1	1	1
1	1	1	1	1	1	1