1	1	1	1	1	1	1
1	1	1	1	1	1	1
1	1	0	3	0	1	1
1	1	0	3	0	1	1
0	0	34	34	34	0	0
1	1	0	3	0	1	1
1	1	0	3	0	1	1
1	1	1	1	1	1	1
1	1	1	1	1	1	1