1	1	1	1	1	1	1
1	1	0	0	1	1	1
1	1	0	34	1	1	1
0	0	0	34	1	1	1
0	2	2	34	2	2	0
1	1	1	34	0	0	0
1	1	1	34	0	1	1
1	1	1	0	0	1	1
1	1	1	1	1	1	1