1	1	1	1	1	1	1
1	0	2	2	2	0	1
1	0	2	2	2	0	1
1	35	0	0	0	35	1
1	35	35	0	35	35	1
1	35	0	0	0	35	1
1	0	2	2	2	0	1
1	0	2	2	2	0	1
1	1	1	1	1	1	1