1	1	1	1	1	1	1
1	1	1	1	1	1	1
1	1	0	35	0	1	1
0	0	0	35	0	0	0
35	35	35	35	35	35	35
0	0	0	35	0	0	0
1	1	0	35	0	1	1
1	1	1	1	1	1	1
1	1	1	1	1	1	1