0	0	1	1	1	1	1
0	1	1	1	0	34	1
1	1	1	0	3	34	1
1	1	0	3	3	34	1
1	0	3	3	3	0	1
1	34	3	3	0	1	1
1	34	3	0	1	1	1
1	34	0	0	1	1	0
1	1	1	1	1	0	0